1111111111111111111111111111111111111111111111111111111111111111
1...........B..................11...........B..................1
1..P...........................11..P...........................1
1..............................11..............................1
1..............................11..............................1
1.......11111......11111.......11.......11111......11111.......1
1.......1..............1.......11.......1..............1.......1
1.......1..............1.......11.......1..............1.......1
1.......1..............1.......11.......1..............1.......1
1.......1..............1.......11.......1..............1.......1
1..............................11..............................1
1..............11..............11..............11..............1
1..............11..............11..............11..............1
1..............................11..............................1
1.......1..............1.......11.......1..............1.......1
1.......1..............1.......11.......1..............1.......1
1.......1..............1.......11.......1..............1.......1
1.......1..............1.......11.......1..............1.......1
1.......11111......11111.......11.......11111......11111.......1
1..............................11..............................1
1..............................11..............................1
1..............................11..............................1
1..............................11..............................1
1..............................11..............................1
1..............................11..............................1
1..............................11..............................1
1..............................11..............................1
1.......11111......11111.......11.......11111......11111.......1
1..............................11..............................1
1..............................11..............................1
1..............................11..............................1
1..............................11..............................1
1..............................11..............................1
1..............................11..............................1
1..............................11..............................1
1.......11111......11111.......11.......11111......11111.......1
1..............................11..............................1
1..............................11..............................1
1..............................11..............................1
1.......11111......11111.......11.......11111......11111.......1
1.......1..............1.......11.......1..............1.......1
1.......1..............1.......11.......1..............1.......1
1.......1..............1.......11.......1..............1.......1
1.......1..............1.......11.......1..............1.......1
1..............................11..............................1
1..............................11..............................1
1..............................11..............................1
1..............................11..............................1
1..............................11..............................1
1.......11111......11111.......11.......11111......11111.......1
1.......11111......11111.......11.......11111......11111.......1
1.......11111......11111.......11.......11111......11111.......1
1.......11111......11111.......11.......11111......11111.......1
1.......1111111111111111.......11.......1111111111111111.......1
1..............................11..............................1
1..............................11..............................1
1..............................11..............................1
1.111......................111.11.111......................111.1
1..............................11..............................1
1...........11111111...........11...........11111111...........1
1.....11.......................11.....11.......................1
1.......................11.....11.......................11.....1
1..............................11..............................1
1...111111111111111111111111...11...111111111111111111111111...1
1..............................11..............................1
1..............................11..............................1
1.......1111111111111111.......11.......1111111111111111.......1
1.......1111111111111111.......11.......1111111111111111.......1
1.......1111111111111111.......11.......1111111111111111.......1
1.......1111111111111111.......11.......1111111111111111.......1
1.......1111111111111111.......11.......1111111111111111.......1
1...........................C..11...........................C..1
1..............................11..............................1
1..............................11..............................1
1..............................11..............................1
1..............................11..............................1
1..............................11..............................1
1..............................11..............................1
1111111111111111111111111111111111111111111111111111111111111111